#.............#
...........#..X
....+.#........
........#....*.
..............F
.#..........#+.
.....#.........
...#...........
...S..#........
#X.......+....#