#########F#####
#.............#
#.............#
#.............#
#........*....#
#.............#
#.............#
#........0.0..#
#.............#
###########S###