###############
#             #
#             #
#             #
#             #
#             #
#             #
#        +*+  #
#             #
#########F#S###